L1_device1=[[0,0,0,0,0,0,0,0],
        [0,0,0,1,1,1,1,1],
        [0,0,0,1,1,1,1,1],
        [0,0,0,1,1,1,1,1],
        [0,0,0,1,1,1,1,1],
        [0,0,0,1,1,1,1,1],
        [0,0,0,0,0,0,0,0],
        [0,0,0,0,0,0,2,2]]


L1_device2=[[0,0,0,0,0,0,0,0],
        [0,0,0,0,0,0,0,0],
        [1,1,1,1,1,0,0,0],
        [1,1,1,1,1,0,0,0],
        [1,1,1,1,1,0,0,0],
        [1,1,1,1,1,0,0,0],
        [0,0,0,0,0,0,0,0],
        [2,2,0,0,0,0,0,0]]



L1_device3=[[0,0,0,0,0,0,2,2],
        [0,0,0,0,0,0,0,0],
        [0,0,0,0,0,0,0,0],
        [0,0,0,0,0,0,0,0],
        [0,0,0,0,0,0,0,0],
        [0,0,0,0,0,0,0,0],
        [0,0,0,0,0,0,0,0],
        [0,0,0,0,0,0,0,0]]

L1_device4=[[2,2,0,0,0,0,0,0],
        [0,0,0,0,0,0,0,0],
        [0,0,0,0,0,0,0,0],
        [0,0,0,0,0,0,0,0],
        [0,0,0,0,0,0,0,0],
        [0,0,0,0,0,0,0,0],
        [0,0,0,0,0,0,0,0],
        [0,0,0,0,0,0,0,0]]

L2_device1=[[0,0,0,0,0,0,0,0],
        [0,0,0,0,0,0,0,0],
        [0,0,0,0,0,0,0,0],
        [0,0,0,1,1,0,1,1],
        [0,0,0,1,1,0,1,1],
        [0,0,0,1,1,0,1,1],
        [0,0,0,1,1,0,1,1],
        [0,0,0,1,1,0,0,0]]

L2_device2=[[0,0,0,0,0,0,0,0],
        [0,0,0,0,0,0,0,0],
        [0,0,0,0,0,0,0,0],
        [1,1,1,1,0,0,0,0],
        [1,1,1,0,0,0,0,0],
        [1,1,1,0,0,0,0,0],
        [1,1,1,0,0,0,0,0],
        [2,2,0,0,0,0,0,0]]

L2_device3=[[0,0,0,1,1,0,0,0],
        [0,0,0,0,0,0,0,0],
        [0,0,0,0,0,0,0,0],
        [0,0,0,0,0,0,0,0],
        [0,0,0,0,0,0,0,0],
        [0,0,0,0,0,0,0,0],
        [0,0,0,0,0,0,0,0],
        [0,0,0,0,0,0,0,0]]

L2_device4=[[2,2,0,0,0,0,0,0],
        [0,0,0,0,0,0,0,0],
        [0,0,0,0,0,0,0,0],
        [0,0,0,0,0,0,0,0],
        [0,0,0,0,0,0,0,0],
        [0,0,0,0,0,0,0,0],
        [0,0,0,0,0,0,0,0],
        [0,0,0,0,0,0,0,0]]



L3_device1=[[0,0,0,0,0,0,0,0],
        [0,0,0,0,0,0,0,0],
        [0,0,0,0,1,1,1,1],
        [0,0,0,0,1,1,1,1],
        [0,0,0,0,1,1,1,1],
        [0,0,1,1,0,0,0,0],
        [0,0,1,1,0,0,0,0],
        [0,0,1,1,0,0,0,2]]

L3_device2=[[0,0,0,0,0,0,0,0],
        [0,0,0,0,0,0,0,0],
        [1,1,1,0,0,0,0,0],
        [1,1,1,0,0,0,0,0],
        [1,1,1,0,0,0,0,0],
        [0,0,0,0,0,0,0,0],
        [0,0,0,0,0,0,0,0],
        [2,2,0,0,0,0,0,0]]

L3_device3=[[0,0,0,0,0,0,0,2],
        [0,0,0,0,0,0,0,0],
        [0,0,0,0,1,1,1,1],
        [0,0,0,0,1,1,1,1],
        [0,0,0,0,1,1,1,1],
        [0,0,1,1,0,0,0,0],
        [0,0,1,1,0,0,0,0],
        [0,0,1,1,0,0,2,2]]

L3_device4=[[2,2,0,0,0,0,0,0],
        [0,0,0,0,0,0,0,0],
        [0,0,0,0,0,0,0,0],
        [0,0,0,0,0,0,0,0],
        [0,0,0,0,0,0,0,0],
        [0,0,0,0,0,0,0,0],
        [0,0,0,0,0,0,0,0],
        [0,0,0,0,0,0,0,0]]



L4_device1=[[0,0,0,0,0,0,0,0],
        [0,0,0,1,1,1,1,1],
        [0,0,0,1,1,1,1,1],
        [0,0,0,1,1,1,1,1],
        [0,0,0,1,1,1,1,1],
        [0,0,1,1,0,0,0,0],
        [0,0,1,1,0,0,0,0],
        [0,0,1,1,0,0,2,2]]

L4_device2=[[0,0,0,0,0,0,0,0],
        [1,1,1,1,1,0,0,0],
        [1,1,1,1,1,0,0,0],
        [1,1,1,1,1,0,0,0],
        [1,1,1,1,1,0,0,0],
        [0,0,0,0,1,1,0,0],
        [0,0,0,0,1,1,0,0],
        [2,2,0,0,1,1,0,0]]

L4_device3=[[0,0,1,1,0,0,2,2],
        [0,0,0,0,0,0,0,0],
        [0,0,0,0,0,0,0,0],
        [0,0,0,0,0,0,0,0],
        [0,0,0,0,0,0,0,0],
        [0,0,0,0,0,0,0,0],
        [0,0,0,0,0,0,0,0],
        [0,0,0,0,0,0,0,0]]

L4_device4=[[2,2,0,0,1,1,0,0],
        [0,0,0,0,0,0,0,0],
        [0,0,0,0,0,0,0,0],
        [0,0,0,0,0,0,0,0],
        [0,0,0,0,0,0,0,0],
        [0,0,0,0,0,0,0,0],
        [0,0,0,0,0,0,0,0],
        [0,0,0,0,0,0,0,0]]


L5_device1=[[0,0,0,0,0,0,0,0],
        [0,0,0,0,0,0,0,0],
        [0,0,0,0,0,0,0,0],
        [0,0,0,0,0,0,0,0],
        [0,0,0,0,0,0,0,0],
        [0,0,0,0,0,0,0,0],
        [0,0,0,0,0,0,0,0],
        [0,0,0,0,0,0,0,0]]

L5_device2=[[0,0,0,0,0,0,0,0],
        [0,1,1,1,1,1,1,1],
        [0,1,1,1,1,1,1,1],
        [0,1,1,1,1,1,1,1],
        [0,1,1,1,1,1,1,1],
        [0,1,1,1,1,1,1,1],
        [0,0,0,0,0,0,0,0],
        [0,2,2,2,2,2,2,0]]

L5_device3=[[0,0,0,3,3,0,0,0],
        [0,0,0,3,3,3,0,0],
        [0,0,0,3,3,3,0,0],
        [0,0,0,0,0,0,0,0],
        [0,0,0,0,0,0,0,0],
        [0,0,0,0,0,0,0,0],
        [0,0,0,0,0,0,0,0],
        [0,0,0,0,0,0,0,0]]

L5_device4=[[0,0,0,0,0,0,0,0],
        [0,0,0,0,0,0,0,0],
        [0,0,0,0,0,0,0,0],
        [0,0,0,0,0,0,0,0],
        [0,0,0,0,0,0,0,0],
        [0,0,0,0,0,0,0,0],
        [0,0,0,0,0,0,0,0],
        [0,0,0,0,0,0,0,0]]



L6_device1=[[0,0,0,0,0,0,0,0],
        [0,0,0,0,0,0,3,3],
        [0,0,0,0,0,0,3,3],
        [0,0,0,0,0,0,3,3],
        [0,0,0,0,0,0,0,0],
        [0,0,0,0,0,0,0,0],
        [0,0,0,0,0,0,0,0],
        [0,0,0,0,0,1,1,1]]

L6_device2=[[0,0,0,0,0,0,0,0],
        [3,3,0,0,0,0,0,0],
        [3,3,0,0,0,0,0,0],
        [3,3,0,0,0,0,0,0],
        [0,0,0,0,0,0,0,0],
        [0,0,0,0,0,0,0,0],
        [0,0,0,0,0,0,0,0],
        [1,1,1,0,0,0,0,0]]

L6_device3=[[0,0,0,0,0,1,1,1],
        [0,0,0,0,0,0,0,0],
        [0,0,0,0,0,0,3,3],
        [0,0,0,0,0,0,3,3],
        [0,0,0,0,0,0,0,0],
        [0,0,0,0,0,0,0,0],
        [0,0,0,0,0,0,0,0],
        [0,0,0,0,0,0,0,0]]

L6_device4=[[1,1,1,0,0,0,0,0],
        [0,0,0,0,0,0,0,0],
        [3,3,0,0,0,0,0,0],
        [3,3,0,0,0,0,0,0],
        [0,0,0,0,0,0,0,0],
        [0,0,0,0,0,0,0,0],
        [0,0,0,0,0,0,0,0],
        [0,0,0,0,0,0,0,0]]


L7_device1=[[0,0,0,0,0,0,0,0],
        [0,0,0,0,1,1,1,1],
        [0,1,1,1,1,1,1,1],
        [0,1,1,1,1,1,1,1],
        [0,1,1,1,1,1,1,1],
        [0,1,1,1,1,1,1,1],
        [0,0,0,0,0,0,0,0],
        [0,0,0,0,0,0,0,2]]

L7_device2=[[0,0,0,0,0,0,0,0],
        [0,0,0,0,0,1,1,1],
        [0,0,0,0,0,1,1,1],
        [0,0,0,0,0,1,1,1],
        [0,0,0,0,0,1,1,1],
        [0,0,0,0,0,1,1,1],
        [0,0,0,0,3,3,0,0],
        [2,2,0,0,3,3,0,0]]

L7_device3=[[0,0,0,0,0,0,0,0],
        [0,0,0,0,0,0,0,0],
        [0,0,0,0,0,0,0,0],
        [0,0,0,0,0,0,0,0],
        [0,0,0,0,0,0,0,0],
        [0,0,0,0,0,0,0,0],
        [0,0,0,0,0,0,0,0],
        [0,0,0,0,0,0,0,0]]

L7_device4=[[0,0,0,0,0,0,0,0],
        [0,0,0,0,0,0,0,0],
        [0,0,0,0,0,0,0,0],
        [0,0,0,0,0,0,0,0],
        [0,0,0,0,0,0,0,0],
        [0,0,0,0,0,0,0,0],
        [0,0,0,0,0,0,0,0],
        [0,0,0,0,0,0,0,0]]


L8_device1=[[0,0,0,0,0,1,1,1],
        [0,0,0,0,0,1,1,1],
        [0,0,0,0,0,1,1,1],
        [0,0,0,0,0,1,1,1],
        [0,0,0,0,0,0,0,0],
        [0,0,0,0,0,0,0,2],
        [0,0,0,0,0,0,0,2],
        [0,0,0,0,0,0,0,0]]

L8_device2=[[1,1,1,0,0,0,0,0],
        [1,1,1,0,0,0,0,0],
        [1,1,1,0,0,0,0,0],
        [1,1,1,0,0,0,0,0],
        [0,0,0,0,0,0,0,0],
        [2,0,0,0,0,0,0,0],
        [2,0,0,0,0,0,0,0],
        [0,0,0,0,0,0,0,0]]

L8_device3=[[0,0,0,0,0,0,0,0],
        [0,0,0,0,0,0,0,0],
        [0,0,0,0,0,0,0,0],
        [0,0,0,0,0,0,0,0],
        [0,0,0,0,0,0,0,0],
        [0,0,0,0,0,0,3,3],
        [0,0,0,0,0,0,3,3],
        [0,0,0,0,0,0,0,0]]

L8_device4=[[0,0,0,0,0,0,0,0],
        [0,0,0,0,0,0,0,0],
        [0,0,0,0,0,0,0,0],
        [0,0,0,0,0,0,0,0],
        [0,0,0,0,0,0,0,0],
        [3,3,0,0,0,0,0,0],
        [3,3,0,0,0,0,0,0],
        [0,0,0,0,0,0,0,0]]


L9_device1=[[0,0,0,0,0,0,0,0],
        [0,0,0,0,0,0,0,0],
        [0,0,0,0,0,0,0,0],
        [0,0,0,0,0,0,4,4],
        [0,0,0,0,0,0,4,4],
        [0,0,0,0,0,0,4,4],
        [0,0,0,0,0,0,4,4],
        [0,0,0,0,0,0,4,4]]

L9_device2=[[0,0,0,0,0,0,0,0],
        [0,0,0,0,0,0,0,0],
        [0,0,0,0,0,0,0,0],
        [4,4,0,0,0,0,0,0],
        [4,4,0,0,0,0,0,0],
        [4,4,0,0,0,0,0,0],
        [4,4,0,0,0,0,0,0],
        [4,4,0,0,0,0,0,0]]

L9_device3=[[0,0,0,0,0,0,4,4],
        [0,0,0,0,0,0,4,4],
        [0,0,3,3,3,3,3,0],
        [0,0,3,3,3,3,3,0],
        [0,0,3,3,3,3,3,0],
        [0,0,3,3,3,3,3,0],
        [0,0,3,3,3,3,3,0],
        [0,0,0,0,0,0,0,0]]

L9_device4=[[4,4,0,0,0,0,0,0],
        [4,4,0,0,0,0,0,0],
        [0,0,0,0,0,0,0,0],
        [0,0,0,0,0,0,0,0],
        [0,0,0,0,0,0,0,0],
        [0,0,0,0,0,0,0,0],
        [0,0,0,0,0,0,0,0],
        [0,0,0,0,0,0,0,0]]


L10_device1=[[0,0,0,0,0,0,0,0],
        [0,0,0,0,0,0,4,4],
        [0,0,0,0,0,0,4,4],
        [0,0,0,0,0,0,4,4],
        [0,0,0,0,0,0,4,4],
        [0,0,0,0,0,0,4,4],
        [0,0,0,0,0,0,4,4],
        [0,0,0,0,0,0,4,4]]

L10_device2=[[0,0,0,0,0,0,0,0],
        [4,4,0,0,0,0,0,0],
        [4,4,0,0,0,0,0,0],
        [4,4,0,0,0,3,3,0],
        [4,4,0,0,0,3,3,0],
        [4,4,0,0,0,3,3,0],
        [4,4,0,0,0,3,3,0],
        [4,4,0,0,0,3,3,0]]

L10_device3=[[0,0,0,0,0,0,0,0],
        [0,0,0,0,0,0,0,0],
        [0,0,0,0,0,0,0,0],
        [0,0,0,0,0,0,0,0],
        [0,0,0,0,0,0,0,0],
        [0,0,0,0,0,0,0,0],
        [0,0,0,0,0,0,0,0],
        [0,0,0,0,0,0,0,0]]

L10_device4=[[0,0,0,0,0,0,0,0],
        [0,0,0,0,0,0,0,0],
        [0,0,0,0,0,0,0,0],
        [0,0,0,0,0,0,0,0],
        [0,0,0,0,0,0,0,0],
        [0,0,0,0,0,0,0,0],
        [0,0,0,0,0,0,0,0],
        [0,0,0,0,0,0,0,0]]
